#######################
#.p.p..p...p...p..p.p.#
#. #.#..#. . .#..#.# .#
#. #......###......# .#
#. ..#.p.p.#.p.p.#.. .#
#. #.#..#.....#..#.# .#
#. ..p.   p#p   ..p. .#
#. #...#########...# .#
#. #...#  p#p  #.p.# .#
#. p.p.p.p.#.p..p.p. .#
#. #.####.###.####.# .#
#. #.p. .p.#p.p .p.# .#
#. p.p.#.p.p.p.#.p.p .#
# ## #.# .###. #.# ## #
#. #  .p.p. .p.p.  # .#
#. ..##p.p.#.p.p##.. .#
#. .p.#...   ...#.p. .#
#. #.p.p   #   p.p.# .#
#. p.p..#######.p.p. .#
#  #.pp    P    pp.#  #
#######################