#######################
#c.c..c..c..c..c.c.c..#
#.#.#.####.#.####.#.#.#
#.#.#.####.#.####.#.#.#
#.#.#.####.#.####.#.#.#
#.#.c.c###.#.###.c.c#.#
#.#.##.c.c. .c.c.##.c.#
#.c.##.####.####.##.c.#
#.#.c..##.c.c.##.c.c#.#
#...## #  c#c  # ##...#
#.#.## #  c#c  # ##.#.#
#.c.c..##.ccc.##.c.c.c#
##.###.####.####.###..#
#.c.#.c.c..c.c..c.#...#
#.#.#c.c.c.c.c..c.#.#.#
#.c.#c.#########..#.c.#
##..#.c.c..P.c.cc.#..##
#.c.#.#####.#####.#.c.#
#.#...####...####...#.#
# .c..c..c...c..c..c. #
#######################