#######################
#i.i..i..i..i..i.i.i..#
#.#.#.####.#.####.#.#.#
#.#.#.####.#.####.#.#.#
#.#.#.####.#.####.#.#.#
#.#.i.i###.#.###.i.i#.#
#.#.##.i.i. .i.i.##.i.#
#.i.##.####.####.##.i.#
#.#.i..##.i.i.##.i.i#.#
#...## #  i#i  # ##...#
#.#.## #  i#i  # ##.#.#
#.i.i..##.iii.##.i.i.i#
##.###.####.####.###..#
#.i.#.i.i..i.i..i.#...#
#.#.#i.i.i.i.i....#.#.#
#.i.#i.#########..#.i.#
##..#.i.i..P.i.i..#..##
#.i.#.#####.#####.#.i.#
#.#...####...####...#.#
# .i..i..i...i..i..i. #
#######################