#######################
#..p..#.p..#.p..#.p.p.#
#.###..p.#...#..p.###.#
#.### #   .#.   # ###.#
#.p#.  .##. .##.  .#c.#
#.p#.##. p. p. .##.#p.#
##. .##.# #.# #.##. .##
# .#.. . .p.p. . ..#. #
# .#..#.#..#..#.#..#. #
# p.p.#.p.. ..p.#.p.p #
# #.###.#.###.#.###.# #
# #... .... .... ...# #
# ...##.#######.##.p. #
# ##.##..p.#.p..##.## #
#. .p.p.. .#. .p.p.. .#
#.#..####..#..####..#.#
#.#.p.  .p. .p.  .p.#.#
#.#.p.p .#.p.#. .p.p#.#
#.#### # ##### # ####.#
#.p..p..p..P.p..p..p..#
#######################