#######################
#b.b..b..b..b..b.b.b..#
#.#.#.####.#.####.#.#.#
#.#.#.####.#.####.#.#.#
#.#.#.####.#.####.#.#.#
#.#.b.b###.#.###.b.b#.#
#.#.##.b.b. .b.b.##.b.#
#.b.##.####.####.##.b.#
#.#.b..##.b.b.##.b.b#.#
#...## #  b#b  # ##...#
#.#.## #  b#b  # ##.#.#
#.b.b..##.bbb.##.b.b.b#
##.###.####.####.###..#
#.b.#.b.b..b.b..b.#...#
#.#.#b.b.b.b.b..b.#.#.#
#.b.#b.#########..#.b.#
##..#.b.b..P.b.bb.#..##
#.b.#.#####.#####.#.b.#
#.#...####...####...#.#
# .b..b..b...b..b..b. #
#######################