#######################
#. ..  ..b..b...  .. .#
#. #   ...#.#... b # .#
#.  . ## ##.## ##b   .#
#  #.## .b..b.. ##.#  #
# ... #   ###   # ... #
#.# # .b. ### .b. # #.#
#.#b  #...###...#...#.#
#. b ####.b.b.####.. .#
#.# .b.  ..#..  .b. #.#
#..b  # #.. ..# #  .b.#
##  # ... #.# ... #  ##
# .b. ###.. ..### .b. #
# .b.b.. b.#.b .b.b.. #
#. ##. .#.   .#. .## .#
#  . .b .b . .b .. .  #
#.###.#. .#.#. .#.###.#
#.#.b.b. .b..b .b.b.#.#
#. .# #...#.#...# #. .#
#  .b. b.b P .b. b.b  #
#######################