#######################
#p.p..p..p..p..p.p.p..#
#.#.#.####.#.####.#.#.#
#.#.#.####.#.####.#.#.#
#.#.#.####.#.####.#.#.#
#.#.p.p###.#.###.p.p#.#
#.#.##.p.p. .p.p.##.p.#
#.p.##.####.####.##.p.#
#.#.p..##.p.p.##.p.p#.#
#...## #  p#p  # ##...#
#.#.## #  p#p  # ##.#.#
#.p.p..##.ppp.##.p.p.p#
##.###.####.####.###..#
#.p.#.p.p..p.p..p.#...#
#.#.#p.p.p.p.p..p.#.#.#
#.p.#p.#########..#.p.#
##..#.p.p..P.p.pp.#..##
#.p.#.#####.#####.#.p.#
#.#...####...####...#.#
# .p..p..p...p..p..p. #
#######################