#######################
#. ..  ..c..c...  .. .#
#. #   ...#.#... c # .#
#.  . ## ##.## ##c   .#
#  #.## .c..c.. ##.#  #
# ... #   ###   # ... #
#.# # .c. ### .c. # #.#
#.#c  #...###...#...#.#
#. c ####.c.c.####.. .#
#.# .c.  ..#..  .c. #.#
#..c  # #.. ..# #  .c.#
##  # ... #.# ... #  ##
# .c. ###.. ..### .c. #
# .c.c.. c.#.c .c.c.. #
#. ##. .#.   .#. .## .#
#  . .c .c . .c .. .  #
#.###.#. .#.#. .#.###.#
#.#.c.c. .c..c .c.c.#.#
#. .# #...#.#...# #. .#
#  .c. c.c P .c. c.c  #
#######################