#######################
#..i..#.i..#.i..#.i.i.#
#.###..i.#...#..i.###.#
#.### #   .#.   # ###.#
#.i#.  .##. .##.  .#i.#
#.i#.##. i. i. .##.#i.#
##. .##.# #.# #.##. .##
# .#.. . .i.i. . ..#. #
# .#..#.#..#..#.#..#. #
# i.i.#.i.. ..i.#.i.i #
# #.###.#.###.#.###.# #
# #... .... .... ...# #
# ...##.#######.##.i. #
# ##.##..i.#.i..##.## #
#. .i.i.. .#. .i.i.. .#
#.#..####..#..####..#.#
#.#.i.  .i. .i.  .i.#.#
#.#.i.i .#.i.#. .i.i#.#
#.#### # ##### # ####.#
#.i..i..i..P.i..i..i..#
#######################