#######################
#.i.i..i...i...i..i.i.#
#. #.#..#. . .#..#.# .#
#. #......###......# .#
#. ..#.i.i.#.i.i.#.. .#
#. #.#..#.....#..#.# .#
#. ..i.   i#i   ..i. .#
#. #...#########...# .#
#. #...#  i#i  #...# .#
#. i.i.i.i.#........ .#
#. #.####.###.####.# .#
#. #.i. .i.#i.i .i.# .#
#. i.i.#.i.i.i.#.i.i .#
# ## #.# .###. #.# ## #
#. #  .i.i. .i.i.  # .#
#. ..##i.i.#.i.i##.. .#
#. .i.#...   ...#.i. .#
#. #.i.i   #   i.i.# .#
#. i.i..#######.i.i. .#
#  #.ii    P    ii.#  #
#######################